1111111
1000001
1010101
1011101
1000001
1111111
